ank mšo bn kmš mlk mab hd
ybny | aby mlk ol mab šlšn št wank mlk
ty aḥr aby | waoš hbmt zat lkmš bqrḥh | b[ns y]
šo ky hšony mkl hmlkn wky hrany bkl šnay | omr
y mlk yšral wyonw at mab ymn rbn ky yanp kmš bar
ṣh | wyḥlph bnh wyamr gm ha aonw at mab | bymy amr k[…]
wara bh wbbth | wyšral abd abd olm wyrš omry at a[r]
ṣ mhdba | wyšb bh ymh wḥṣy ymy bnh arbon št wyš
bh kmš bymy | wabn at bolmon waoš bh hašwḥ wabn
at qrytn | waš gd yšb barṣ oṭrt molm wybn lh mlk y
šral at oṭrt | waltḥm bqr waḥzh | wahrg at kl hom [m]
hqr ryt lkmš wlmab | wašb mšm at aral dwdh was
ḥbh lpny kmš bqryt | wašb bh at aš šrn wat aš
mḥrt | wyamr ly kmš lk aḥz at nbh ol yšral | wa
hlk hllh waltḥm bh mbqo hšḥrt od hṣhrm | waḥ
zh wahrg klh šbot alpn gbrn w[gr]n | wgbrt wgr
t wrḥmt | ky loštr kmš hḥrmth | waqḥ mšm a[t k]
ly yhwh wasḥb hm lpny kmš | wmlk yšral bnh at
yhṣ wyšb bh bhltḥmh by | wygršh kmš mpny | w
aqḥ mmab matn aš kl ršh | wašah byhṣ waḥzh
lspt ol dybn | ank bnty qrḥh ḥmt hyorn wḥmt
hopl | wank bnty šoryh wank bnty mgdlth | wa
nk bnty bt mlk wank ošty klay haš[wḥ lmy]n bqrb
hqr | wbr an bqrb hqr bqrḥh wamr lkl hom ošw l
km aš br bbyth | wank krty hmkrtt lqrḥh basr
[y] yšral | ank bnty oror wank ošty hmslt barnn
ank bnty bt bmt ky hrs ha | ank bnty bṣr ky oyn
š dybn ḥmšn ky kl dybn mšmot | wank mlk
t[y] mat bqrn ašr yspty ol harṣ | wank bnt
[y at mh]dba wbt dbltn | wbt bolmon waša šm at […]
ṣan harṣ | wḥwrnn yšb bh b
amr ly kmš rd hltḥm bḥwrnn | ward
[wyš]bh kmš bymy wol[…] mšm oš
št šdq | wa
